0,1,2,0,1,2,0,1,2,0,1,2,0,1,2,0,1,2,0,1,2,0,1,2,0,1,2,0,1,2
0,1,2,0,1,2,0,1,2,0,1,2,0,1,2,0,1,2,0,1,2,0,1,2,0,1,2,0,1,2
0,1,2,0,1,2,0,1,2,0,1,2,0,1,2,0,1,2,0,1,2,0,1,2,0,1,2,0,1,2
0,1,2,0,1,2,0,1,2,0,1,2,0,1,2,0,1,2,0,1,2,0,1,2,0,1,2,0,1,2
0,1,2,0,1,2,0,1,2,0,1,2,0,1,2,0,1,2,0,1,2,0,1,2,0,1,2,0,1,2
0,1,2,0,1,2,0,1,2,0,1,2,0,1,2,0,1,2,0,1,2,0,1,2,0,1,2,0,1,2
0,1,2,0,1,2,0,1,2,0,1,2,0,1,2,0,1,2,0,1,2,0,1,2,0,1,2,0,1,2
0,1,2,0,1,2,0,1,2,0,1,2,0,1,2,0,1,2,0,1,2,0,1,2,0,1,2,0,1,2
0,1,2,0,1,2,0,1,2,0,1,2,0,1,2,0,1,2,0,1,2,0,1,2,0,1,2,0,1,2
0,1,2,0,1,2,0,1,2,0,1,2,0,1,2,0,1,2,0,1,2,0,1,2,0,1,2,0,1,2
0,1,2,0,1,2,0,1,2,0,3,3,3,3,2,0,1,2,0,1,2,0,1,2,0,1,2,0,1,2
0,1,2,0,1,2,0,1,2,0,3,4,4,3,2,0,1,2,0,1,2,0,1,2,0,1,2,0,1,2
0,1,2,0,1,2,0,1,2,0,3,4,4,3,2,0,1,2,0,1,2,0,1,2,0,1,2,0,1,2
0,1,2,0,1,2,0,1,2,0,3,4,4,3,2,0,1,2,0,1,2,0,1,2,0,1,2,0,1,2
0,1,2,0,1,2,0,1,2,0,3,4,4,3,2,0,1,2,0,1,2,0,1,2,0,1,2,0,1,2
0,1,2,0,1,2,0,1,2,0,3,4,4,3,2,0,1,2,0,1,2,0,1,2,0,1,2,0,1,2
0,1,2,0,1,2,0,1,2,0,3,4,4,3,2,0,1,2,0,1,2,0,1,2,0,1,2,0,1,2
0,1,2,0,1,2,0,1,2,0,3,4,4,3,2,0,1,2,0,1,2,0,1,2,0,1,2,0,1,2
0,1,2,0,1,2,0,1,2,0,3,4,4,3,2,0,1,2,0,1,2,0,1,2,0,1,2,0,1,2
0,1,2,0,1,2,0,1,2,0,3,4,4,3,2,0,1,2,0,1,2,0,1,2,0,1,2,0,1,2
0,1,2,0,1,2,0,1,2,0,3,4,4,3,2,0,1,2,0,1,2,0,1,2,0,1,2,0,1,2
0,1,2,0,1,2,0,1,2,0,3,4,4,3,2,0,1,2,0,1,2,0,1,2,0,1,2,0,1,2
0,1,2,0,1,2,0,1,2,0,3,3,3,3,2,0,1,2,0,1,2,0,1,2,0,1,2,0,1,2
0,1,2,0,1,2,0,1,2,0,1,2,0,1,2,0,1,2,0,1,2,0,1,2,0,1,2,0,1,2
0,1,2,0,1,2,0,1,2,0,1,2,0,1,2,0,1,2,0,1,2,0,1,2,0,1,2,0,1,2
0,1,2,0,1,2,0,1,2,0,1,2,0,1,2,0,1,2,0,1,2,0,1,2,0,1,2,0,1,2
0,1,2,0,1,2,0,1,2,0,1,2,0,1,2,0,1,2,0,1,2,0,1,2,0,1,2,0,1,2
0,1,2,0,1,2,0,1,2,0,1,2,0,1,2,0,1,2,0,1,2,0,1,2,0,1,2,0,1,2
0,1,2,0,1,2,0,1,2,0,1,2,0,1,2,0,1,2,0,1,2,0,1,2,0,1,2,0,1,2
0,1,2,0,1,2,0,1,2,0,1,2,0,1,2,0,1,2,0,1,2,0,1,2,0,1,2,0,1,2